NO ./textures/wall.xpm
SO ./textures/wood.xpm
WE ./textures/blue.xpm
EA ./textures/bricks_yellow.xpm

F 0,100,0
C 0,30,150

        11111
 111    10001
1101    10101
1001111110000111
1000000000000001
1111111111011111
        11011
 111    10001
1101    10101
1001111110000111111111111111111111111111111111111111111111111111111111111111111111111111111111111111111111111111111111111111111111111111111111111111111111111111111111111111111111111111111111111111111111111
1000000000S00000000000000000000000000000000000000000000000000000000000000000000000000000000000000000000000000000000000000000000000000000000000000000000000000000000000000000000000000000000000000000000000001
1111111111011111000000000000000000000000000000000000000000000000000000000000000000000000000000000000000000000000000000000000000000000000000000000000000000000000000000000000000000000000000000000000000000001
1111111111011111000100010001000100010001000000000000000000000000000000000000000000000000000000000000000000000000000000000000000000000000000000000000000000000000000000000000000000000000000000000000000000001
1111111111011111111111111111111111111111111111111111111111111111111111111111111111111111111111111111111111111111111111111111111111111111111111111111111111111111111111111111111111111111111111111111111111111
        11011
 111    10001
1101    10101
1001111110000111
1000000000000001
1111111111011111
        11011
 111    10001
1101    10101
1001111110000111
1000000000000001
1111111111011111
1111111111011111
1111111111111111